****************
*A***         **
* *   ** *******
*   **** *******
** *****  ******
*             B*
****************